 0, 0,0,0,0,6,0,0,0,0,0,0,0,0,0,0,0, 0, 0, 0,0,0,0,0,0,0, 0, 0, 0, 0, 0,0,0,0, 0,0, 0,0, 0,0,0,0,0,0,0,0,0,0,0,0,0,13,13,13,13,13,13,10,13,13,13,13,10,13,13,13,13,13,13,13,13,13,13,13,13,13,13,13,13,13,13,13,13,13,10,13,13,13,13,13,10,10,13,13,13,13,13,13,10,13,13,13,13,13,13,10,10,10,10,10,10,10,10,10,10
 3, 0,0,0,0,0,0,0,0,0,0,3,0,0,0,0,0, 0, 0, 3,0,0,0,0,0,0, 0, 0, 0, 0, 0,0,0,0, 0,0, 0,0, 0,0,0,0,0,0,0,0,0,0,0,0,0, 0, 0, 0, 0, 0, 0,10, 0, 0, 0, 0,10, 0, 0, 0, 0, 0, 0, 0, 0, 0, 0, 0, 0, 0, 0, 0, 0, 0, 0, 0, 0, 0,10, 0, 0, 0, 0, 0,10,10, 0, 0, 0, 0, 0, 0,10, 0, 0, 0, 0, 0, 0,10,10,10,10,10,10,10,10,10,10
 0, 0,0,0,0,0,0,0,0,0,0,0,0,0,9,0,0, 0, 0, 0,0,0,0,9,0,0, 0, 0, 0, 0, 0,0,0,0, 0,0, 0,0,23,0,0,0,0,0,0,0,0,0,0,0,0, 0, 0, 0, 0, 0, 0,10, 0, 0, 0, 0,10, 0, 0, 0, 0, 0, 0, 0, 0, 0, 0, 0, 0, 0, 0, 0, 0, 0, 0, 0, 0, 0,10, 0, 0, 0, 0, 0,10,10, 0, 0, 0, 0, 0, 0,10, 0, 0, 0, 0, 0, 0,10,10,10,10,16,10,10,10,10,10
 0, 0,0,0,0,0,0,4,5,0,0,0,0,0,0,0,0, 0,21,21,0,0,0,0,0,0, 0,21,21,21,22,0,0,0,24,0,25,0, 0,0,0,0,0,8,0,0,8,0,0,0,0, 0, 0, 0, 0, 0, 0,15, 0, 0, 0, 0,10, 0, 0, 0, 0, 0, 0, 0, 0, 0, 0, 0, 0, 0, 0, 0, 0, 0, 0, 0, 0, 0,10, 0, 0, 0, 0, 0,10,10, 0, 0, 0, 0, 0, 0,10, 0, 0, 0, 0, 0, 0,10,10,10,10,10,10,10,10,10,10
 2, 2,2,2,2,2,2,2,2,2,2,2,2,2,2,2,2, 2, 2, 2,2,2,2,2,2,2, 2,2,2,2, 2, 2,2,2,2, 2,2, 2,2, 2,2,2,2,2,2,2,2,2,2,2,2,12,12,12,12,12,12,12,12,12,12,12,12,12,12,12,12,12,12,12,12,12,12,12,12,12,12,12,12,12,12,12,12,12,12,12,12,12,12,12,12,12,12,12,12,12,12,12,12,12,12,12,12,12,12,12,12,12,12,12,12,12,12,12,12
 1, 1,1,1,1,1,1,1,1,1,1,1,1,1,1,1,1, 1, 1, 1,1,1,1,1,1,1, 1,1,1,1, 1, 1,1,1,1, 1,1, 1,1, 1,1,1,1,1,1,1,1,1,1,1,1,11,11,11,11,11,11,11,11,11,11,11,11,11,11,11,11,11,11,11,11,11,11,11,11,11,11,11,11,11,11,11,11,11,11,11,11,11,11,11,11,11,11,11,11,11,11,11,11,11,11,11,11,11,11,11,11,11,11,11,11,11,11,11,11
